..........
..........
..........
..........
..........
..........
.......E..
......###.
.......#..
.......S..