..........
..###.....
...#......
...###....
...#......
......E...
....###...
....#..##.
....####..
.......S..