#################
#.......#.......#
#.......#...G...#
#....G..#.......#
#.......#######.#
#.##......G.....#
D..#............#
#.##....#.......#
#.......#.......#
###.##########..#
#.......#....#..#
#..G....#.G.....#
#################