#################
#.......#.......#
#.......#.......#
#.......#.......#
#.......#######.#
#.##............#
D..#............#
#.##....#.......#
#.......#.......#
###.##########..#
#.......#....#..#
#.......#.......#
#################