#################
#...............#
#.........#.....#
#.........#.....#
#...............#
#....#..#####...#
#........#......D
#..##..###......#
#........##.....#
#.......#.......#
#.......#.......#
#...............#
#################