#################
#...............#
#..G......#.....#
#.........#.....#
#...............#
#....#..#####...#
#....G...#......D
#..##..###......#
#........##.....#
#....G..#.G.....#
#.......#.......#
#...............#
#################