#################
##..............#
#.#..........#..#
#..#........##..#
#...............#
#...............#
#...............#
#...............#
#...............#
#......####.#####
#......#........#
#......#........#
########D########