#################
#........#......#
#...............#
#........#......#
#........#......#
####.########.###
D........#......#
####.###.#......#
#......#.#......#
#...............#
#......#.#......#
#......#.#......#
########D########