#################
#...............#
#...............#
#.......##...####
#.......#.......#
#.......#.......#
#.......#.......D
#####.###########
#........#......#
#...............#
#........#......#
#........#......#
########D########