#################
#...............#
#...............#
#..########.....#
#..#......#.....#
#..#......#..####
D..#......#..#..D
#..#####.##..#..#
#...............#
#..#.........#..#
#..#.........#..#
#..#.........#..#
########D########