#################
#################
##.............##
##.............##
##..G...G...G..##
##.............##
##.............##
##.............##
##.............##
##.............##
##.............##
########.########
########D########