########D########
#...............#
#############...#
#...............#
#..##############
#.............###
#############.###
#####.........###
#####.###########
#...............#
#...............#
#...............#
#################