########D########
#...............#
#....#.....#....#
#....#######....#
#.......#.......#
#.......#.......#
D...#########...D
#.......#.......#
#.......#.......#
#....#######....#
#...............#
#.......#.......#
#################