########D########
#....#......#...#
#....#......#...#
#....#......#...#
#.G..#......#.G.#
#....#..G...##.##
#....#..........#
##..##......##.##
#...........#...#
#...........#...#
#...........#...#
#...........#.G.#
########D########