########D########
##..............#
#.#....G.....#..#
#..#........##..#
#.G.............#
#...............#
D......G.....G..D
#...............#
#............G..#
#.......###.#####
#.......#.......#
#...............#
########D########