########D########
#G..............#
#...........G...#
#.....G.........#
#...............#
#......###......#
#...G..#.#......#
#......#.#......#
#....#.....#....#
#....#######....#
#......G........#
#...............#
#################