########D########
#...............#
#............G..#
#.....G.........#
#...............#
#......###......#
#......#.#......#
#......#.#......#
#....#.....#....#
#....#######....#
#............R..#
#...............#
#################