########D########
#...............#
#...............#
#...............#
#...............#
#......###......#
#......#.#......#
#......#.#......#
#....#.....#....#
#....#######....#
#...............#
#...............#
#################