..E.......
..###.....
...#......
...###....
...#......
...##.....
....###...
......##..
......##..
.......S..