..E.......
..###.....
...#......
...###....
...#......
...##.....
..........
..........
.......E..
.......S..